1111111111111111111111111111111111111111
1111111111111111111111111111111111111111
1100000000000010110000000000111111110011
1100001000000010010010000000001111111011
1101101000000010010010000000001111110011
1110101101111010010011000000001000000011
1110101100000011011011000000000000000011
1110100001111011011000111000000000001111
1110100001111001011001100000000011010011
1110110100000001000001000010111100011111
1111010100000000010001001010000000000011
1111010000000111111101001010000000111111
1100000000001110111100000000001111000111
1100111110111110110000000111100000001111
1111000100000000000000110100011110001011
1111001110000000100100100100110110010011
1110000000010110100110100100010001100011
1100100011010010100010100100011110000011
1111110000010010100010010000000000001111
1100111001010010100010000000001111000011
1110000001111010110010000110100010010011
1110001111100011010001010000100010110011
1111111100000000010001010011110100100011
1110000000000000010001001000000001100111
1101111000000000010001001000001001111111
1111111000000000011001001011111000000011
1100111100000000001001101110000000000111
1101111100000000001001000000000011111111
1101001100010000000000000001111001000011
1100101100000000000000000001011001011111
1111111100000000000000000000001000011011
1110000000110000000000000000001001101011
1100011110001000000000000000011001101011
1111100010001000000000000000011000001011
1111100010001000000000000000000000000011
1101000010001111000000000000000000111011
1101111111101111000000000000000000110011
1101111111100001000000000000000000000011
1111111111111111111111111111111111111111
1111111111111111111111111111111111111111