1111111111111111111111111111111111111111
1111111111111111111111111111111111111111
1100011111110000111100011110000111100111
1100000111100000100110000011000111100011
1100000010000010110010000001100000110011
1100001000001100011010000000100000011011
1100111000011000001010000000010000001011
1111110000000001100011000000011100000111
1111000011000000011001100000001000010111
1100000011100110001000110000001000011011
1100001101100001000100011000001100100011
1100001001001101100010001100000101000011
1100000001011110010001000111100010001011
1100000110100011001000100000110000111111
1100110011000001000100110110011000110111
1100100101010011000010010011101000110011
1100001100011010011001011001110100000011
1111010011001010110000000010100110000111
1100000110010100000110000010001011000111
1100000100110010001001000000001101100011
1111100001101101001001100001100110110011
1100010010011000100110110010010000010011
1100110010010010010001100100001011100011
1101000001100110101100001010000101100011
1101000011000001100110000001000110000111
1101011100011001001000000000100110001111
1110000100110010011001100000011100001111
1110000110001100110000011100000000000111
1110011000001001001110011000110000010011
1110000000011011010000000001100000110011
1101101111000100010000000011000001100011
1110100101000100000000011000000011000011
1110010000101000000000001000000110001011
1100010001000000000000000000001100010011
1100001010000000000000000000000000000011
1100001000000000000000000001100001001011
1100000000000000000000000011100001100011
1100010000000000000000000011000000110011
1111111111111111111111111111111111111111
1111111111111111111111111111111111111111
