1111111111111111111111111111111111111111
1111111111111111111111111111111111111111
1100000000000001000111110000001100000011
1100000000000000111100000001100011111011
1100000000000001100000001110001000110111
1100000000111110000001110001011001011011
1100000001010010100001000001010000000011
1100000000000000110100101000101000000011
1111000000000000000000110000101000111011
1100010011101110000000000100100110011111
1110010000001000111011000001110110101011
1101010011001000000011111000010000110111
1101000011011000000010001110000001010011
1101110011000110111101000111000001011111
1100100001000000111100010001110001100011
1100000000000000000110000000101000001111
1111100000000010100110000000001000010011
1110000110000010001100000000000010000011
1111100010000010000000000000010011000111
1101100011000010110000000000001101100011
1100001001000010110000000011000000000011
1100001101100110100000110111100000010111
1100000100100110001100110101110000100111
1111000000110110011000000001111011001011
1111000010011100010000000000001100010011
1111000110000001100111000000011100000011
1111000100110001100011000011000000000111
1100000010011001100110000000100000000011
1100000110001000000111000110110000110011
1100001100100000011000000011100001101011
1111100000110110001100000001000110001011
1110000000010110100100000000001100011011
1110110000000110110000000001110001100011
1111100111000000110000000110000000000111
1101000111100000000000000101100100010111
1100000001111000000000000010001001101011
1100000110011110000000010010010000001011
1111110110100111111000101100100010000011
1111111111111111111111111111111111111111
1111111111111111111111111111111111111111
